XXXXXXXXXXXXXX
XI.XI.XI.XI.RR
IA.CI.AI.CI.AI
IA.......V....A
IT..AI...AI..TI
II...AI...AI.II
IV...AI...AI.VI
IS.XI..T...WP.I
IXI...I...IXI..
IXI.XI.XI.XI.XI