XXXXXXXXXARRRA
ACACACA......A
A.....A......A
I...V.A...V..I
I..A..A......I
I..A..A......A
S..A..A......A
S..X..T..WKP.X
X........X...X
XXXXXXXXXXXXXX